TT TTTTTTTTTTTTTTTTTTTTTTTTTTTTTTTTTTTTTTTT  TTTTTTTTTTTTTTTTTTTTTTTTTTTTTTTTTTTTTTTTTT
TTTTTTTTTTTTTTTTTTTTTTTTTTTTTTTTTTTTTT  TT    TT      TTTT             TTTTTTTTTTT    T
TTT TTTTT  TTTTT  T  TTTTTT   TT                  TT        TTTTT TTT    TTTTTTTTT  D T
TT TTTTTT                         TTTTTTTTTTTTT   T TTTTTT                            T
WW TTT T               TTT  T T   TT  TTTTTT  T TT TTTTTTTTTTTTT    TTTTTT           TT
TWWWWWWT T   TT     T  TTTTTTTTTTTTTTTTTTT TTTT TTTTTTTTTTT  TTTTTTTT               TTT
T WWWWWW    TTTT     TTTTTTTTTTTTTTTTTTTTTTTTTTTTTTTTTTTT  TTTTTT                  TTTT
TTTTTW      WTTTTTTTTTTTTT  TTT TTTTTTTTTTTTTTTTTTTT  TTTTTT                 TTT    TTT
TTTTT     WWWWW WWWWTTTTTTT   TTTTTTTTTTTTT  TTTTTTTTTTTTT                   TTT    TTT
TTT      TTTTWWWWWWWTTTTTTTTTT  TT TTTTTTTTTTTTTTTTTTT                   TTTTTTT   TTTT
TTTT     TTTTTTTTTWWWWWWT TTTTTTT TTTTTTTTTTTTTTTTTTT        d        TTTTTTT      TTTT
TTTT    TT   TTTTTTTTTWWWWWWWTTT TTTTT   TTTTTTTTT                TTTTTTTTTTTTTTT    TT
TTT T   TTTT TTTT  TTTTTTWWWWWWWWTTTTTTTTTTTTT                   TTTT  TTTTTTTTTT   TTT
TTTT     TTT TTTTTTTTTTTTWWWWWWWWWWTTTTTTTTT   T             TTTTTTT TTTTTTTTT TT    TT
TTTT    TT TTTTTTTTTTTTTTTTT TTTWWWWWW WWTT TT             TTTTTTTTTTTTTTTTTTTTT    TTT
TTTT   TTTTTT TTTTTT TTTTTTTTTTWWWWWWWW WWWT   T          TTTTTTT  TTTTTTTTTTTT     TTT
TTT   TT TTTT TTTTTTTTTTTTTTT TTTTWWWWWWWW   TTTT     TTTTT  TTT T TTTTTTTTTTTT     TTT
TTT     TTTTTTTTTTTTTTTTTT TTTT TTTTTTW    WW TTT  TTTTTTTTT TT TT TTTT  TTTTTT     TTT
TTT    TTTTTTTTTTTTTTTTTTTTT TTTTTTT    WWWWWWW WWWTTTTTTTTTT  TT TTTTTTTTTTTTTTT   T  
TTTT    TTTTTTTTT T TTTTTTTT     T   TTTTTWWWWWWWWWWTTTT TTTTT  TTTTTTT TTTTTTTTTT   TT
TTTT       TTTTTTTTTTTT TTT        TTTTTTTTTTTTWWWWWWWWW TTTTTTTTTTTT  TTTTTTTTT    TTT
 T TT  T TTTTTTTT TTTT                TTTTTTTTTTTTWWWWWWW TTTTTTTTTTTT TTTTTTT     TTTT
        TTTTTTTTTTTT       r        TTT TTTTT T TTTWWWWWWWWTTTTTTTTTTTTTTTTTTT     TTTT
  TTT    TTTTTT                   TTTTTTTTTTTT TTTTTTTWWWWWWWTTTTTTTTTTTTTTTTTT    TTTT
  TTT    TTT                  TTT T TTTTTTTTTTTTTTTTTTTTWWWWWWWW  TTT TTTTTTTTT     TTT
TTTTTT   T               TTTTTTTTTTT TTTTT TTT TTTT   TTTTTTWWWWWWWWWW TTTTTTTTTT   TTT
TTTTTT              TTTTTTTTTTT  TTTTTTTTTTTTTTTTT TT  TTTTTTWWWWWWWWTTT    T TT   TTTT
T TTTT          TTTTT TTTTT    TTTTT TTTTTTTTTTTTTTTTTT  TTTTTTTTTWWWWWWWWWT T      TTT
TTTT                TTTTT    TTTTT TTTTTT  TTTTTTTTTT  TTTTTTTTTTTTTTTWWWWWWW    W WWWW
T                               TTT TTTTTT    TTTTT          T  TTTTTTTTWW      WWWWWWW
T R   TTTTTTTTTTTTTT     TT                           TTT            TTT      TTT TTTTW
T     TTTTTTT   TTTTTTTTTTTT TTTTT   TTTTTTTTTTTTT     TTTTTTTTTTT          TTTTTTTTTTT
TTTTTTTTTTTTTT TTTTTTT    TTTTTTTTTTTTTT    TTTTTTT TT  TTTTTTTTTTTTTTTTTTTTTTTTTTTTTTT
